.boy {boy1}
!!!
d###w###w###d
#-----------#
#-$-------1-#
#-----------#
d###w###w###d
!!!