!!!
d###w#####w#####d
#------------DDD#
#-$-----------DD#
#--------------D#
d###w######d---D#
           #---D#
           #---Dw
           w---D#
           #---D#
           #D1-D#
           #DDDD#
           ######
!!!