!!!
d#####          #####d
#------------------1-#
#-$------------------#
#--------------------#
d#####          #####d
!!!