!!!
d###w###w###w###w###w#d
#----------#>---#---1-#
#----#-----#----#-----w
#-$--#----<#----------#
d###w####w#####w###w##d
!!!