.theme {spacetheme1}
.boy {boy2}
!!!
d%%%%%%%%%%%%%d%%%%%%%%%%%%%d
%###########################%
%#######%%%%%%%--vvvvv-----#%
%#--v--#------%------------#d
d#-----#------%DD--------1-#%
%#-$@--#>--d--%DDD---------#%
%#######------%#############%
d%%%%%%%%%d%%%%%%%%%%%%%%%%%d
!!!