!!!
d####d            d####d
#D----<##      ##>---1-#
#------<WWWWWWWW>------#
#-$---<##      ##>---D-#
d####d            d####d
!!!