.boy {boy2}
.theme {spacetheme1}

!!!
         %%%%%%%%%%%
        %%---------%%
%%%%%%%%%------@----%%%%%%
%------------------------%
%-$--------@-----------1-%
%------------------------%
%%%%%%%%%------@----%%%%%%
        %%---------%%
         %%%%%%%%%%%
!!!