!!!
d%%%%%d
%--$--%
%-----%
%-----%
%--@--%
%-----%
%-----%
d-^^^-d
%     %
%     %
%-----%
%-----%
%-----%
%-----%
%--1--%
%DDDDD%
d%%%%%d
!!!