!!!
d%%%%%%%%%%%%%%%%%%%%%%%%%%%d
%-1--#------    ------------%
%----#--^---    d#-#w------D%
%###########>  >---@#-----$D%
%DD------<##    d#w##-----DD%
d%%%%%%%%%%%%%%%%%%%%%%%%%%%d
!!!